WWWWWWWWWWWWWWWWWWWWWWWWW
WFFFFFFFFFFFFFFFFFWFFFFFW
WFFFWFFFFFWWWFFFFFWFFFFFW
WFFFWFFFFFWFFFFFFFWFFFFFW
WFFFWFFFFFWFFFFFFFWFFFFFW
WFFFFFFFFFWWWFFFFFWFFFFFW
WFFFFFFFFFFFFFFFFFFFFFFFW
WFFFFFFFFFWWWWWWWWFFFFFFW
WFFFFFFFFFWWWWWFFFFFFFFFW
WWWWWWWWWWWWWWWWWWWWWWWWW