W WWW

WWW W
WWW W
WWW W

WWW WW WW
W W W   W
WWW 
    W   W
    WW WW